0 0 0 0 0 0 0 0 0 0 0 0 0 0 0 0 0 0 0 0 0 0 0 0 0 0 0 0 0 0 0 0 0 0 0 0 0 0 0 0 0 0 0 0 0 0 0 0
0 0 0 0 0 0 0 0 0 0 0 0 0 0 0 0 0 0 0 14 16 0 0 0 0 0 0 0 0 0 0 0 0 0 0 0 0 0 0 0 0 0 0 0 0 0 0 0
0 0 0 0 0 0 0 0 0 0 0 0 0 0 0 0 0 0 14 18 20 16 0 0 0 0 0 0 0 14 10 10 10 10 10 10 10 16 0 0 0 0 0 0 0 0 0 0
0 0 0 0 0 0 0 0 0 0 0 0 0 0 0 0 0 0 15 13 19 22 23 0 0 0 14 10 10 18 9 29 9 9 51 49 9 20 10 10 10 10 16 0 0 0 0 0
0 0 0 0 0 24 0 0 0 14 10 10 10 16 0 0 0 0 0 0 15 17 0 0 14 10 18 9 9 9 37 9 9 51 47 45 41 41 41 49 9 33 12 0 0 0 0 0
0 0 0 0 0 0 14 10 10 18 9 9 9 20 10 10 16 0 0 0 0 0 0 0 11 9 9 9 29 9 37 39 31 50 46 0 0 0 0 45 49 9 20 16 0 0 0 0
0 0 0 0 0 14 18 9 9 9 9 9 51 41 41 49 20 10 16 0 0 0 0 0 11 9 9 34 9 9 9 9 9 39 50 46 0 0 0 0 45 49 9 20 16 0 0 0
0 0 0 0 14 18 9 9 29 9 9 9 50 46 0 45 49 9 20 10 16 0 0 0 15 19 9 9 9 34 9 9 40 39 9 50 46 0 0 0 0 45 49 9 12 0 0 0
0 0 0 0 11 9 9 29 9 9 9 9 37 50 46 0 42 9 9 9 20 16 0 0 0 15 19 9 9 9 29 9 29 9 9 39 50 10 46 0 0 0 45 49 12 0 0 0
0 0 0 0 11 9 30 9 9 9 9 9 38 9 50 46 42 33 9 9 39 20 16 0 0 0 11 9 9 9 35 9 40 9 9 9 9 51 47 0 56 57 0 42 12 0 0 0
0 0 0 0 15 19 9 9 38 9 9 29 9 9 9 50 48 9 9 9 9 9 12 0 0 0 15 19 34 9 9 9 9 36 9 38 9 43 0 0 0 0 52 42 20 16 0 0
0 0 0 0 0 15 19 9 9 32 38 37 34 29 29 9 9 9 32 9 9 38 20 16 0 0 0 11 9 9 9 29 9 9 9 9 9 43 0 0 0 0 0 45 49 12 0 0
0 0 0 0 0 0 15 13 19 9 9 9 9 9 31 9 9 9 29 9 9 9 9 20 16 0 0 11 9 9 9 9 34 32 38 9 37 50 10 10 10 46 0 0 42 12 0 0
0 0 0 0 0 0 0 0 11 9 9 9 9 9 35 9 9 9 9 9 9 9 9 35 12 0 0 11 9 9 9 30 9 29 9 9 9 9 9 32 9 50 46 44 48 12 0 0
0 0 0 0 0 0 0 0 15 19 9 29 9 30 9 9 9 9 9 9 9 9 9 9 12 0 0 15 19 9 9 9 9 9 9 9 9 32 9 9 9 9 50 48 9 12 0 0
0 0 0 0 0 0 0 0 0 15 19 9 9 9 9 9 9 9 9 9 9 9 34 9 12 0 0 0 15 13 19 9 9 9 9 9 9 9 9 9 9 9 9 9 9 12 0 0
0 0 0 0 0 0 0 0 0 0 11 9 9 9 9 9 9 9 9 36 9 9 9 9 20 16 0 0 0 0 15 13 19 9 9 9 9 9 29 9 32 9 9 9 21 17 0 0
0 0 0 0 0 0 0 0 0 0 11 9 9 9 33 32 9 9 9 9 9 9 31 9 37 12 0 0 0 0 0 0 15 13 19 9 9 9 9 9 9 9 9 21 17 0 0 0
0 0 0 0 0 0 0 0 0 0 11 9 9 9 9 29 9 9 9 9 9 32 9 9 9 20 16 0 0 0 0 0 0 0 15 13 19 9 9 9 31 9 35 12 0 0 0 0
0 0 0 0 0 0 0 0 0 0 11 9 9 9 9 33 9 33 9 9 9 9 9 9 9 9 20 10 16 0 0 0 0 0 0 0 15 19 9 9 9 9 9 12 0 0 0 0
0 0 0 0 0 0 0 0 0 14 18 9 9 40 9 9 32 9 9 9 9 9 37 9 9 9 9 9 20 10 16 0 0 0 0 24 0 11 9 9 9 9 9 20 16 0 0 0
0 0 0 0 0 0 0 0 14 18 9 9 9 9 9 9 9 9 9 9 9 9 29 9 9 9 9 9 34 9 20 16 0 0 0 0 0 11 35 33 30 9 9 9 12 0 0 0
0 0 0 0 0 0 0 14 18 9 9 9 40 9 9 9 9 9 9 9 40 9 9 9 9 51 41 41 49 9 29 20 16 0 0 0 0 11 9 9 9 39 9 9 20 16 0 0
0 0 0 0 0 0 14 18 51 41 41 41 41 41 41 49 39 9 9 9 9 9 9 34 51 47 0 0 45 41 49 40 20 16 0 0 14 18 9 9 37 9 9 9 31 12 0 0
0 0 0 0 0 14 18 51 47 0 0 0 0 0 0 45 49 9 31 37 9 32 9 51 47 0 0 0 56 55 45 49 9 12 0 0 11 9 51 49 9 35 9 9 9 12 0 0
0 0 0 0 0 11 31 43 44 46 0 0 0 0 0 0 42 9 9 9 30 9 51 47 0 0 0 0 0 54 44 48 9 12 0 0 11 51 47 42 37 9 29 9 9 12 0 0
0 0 0 0 0 11 9 43 53 47 0 0 0 0 0 0 42 9 9 9 29 9 43 0 0 0 0 0 0 0 42 9 9 12 0 0 11 50 46 42 9 33 9 32 21 17 0 0
0 0 0 0 0 11 9 43 54 0 0 0 0 0 0 0 42 9 9 9 9 9 50 46 0 0 0 0 0 44 48 9 21 17 0 0 11 9 50 48 9 9 9 9 12 0 0 0
0 0 0 0 14 18 51 47 0 0 0 0 0 0 0 44 48 37 9 32 9 9 31 50 46 0 0 0 0 42 9 9 12 0 0 0 15 19 9 36 30 29 32 9 12 0 0 0
0 0 0 14 18 51 47 52 0 0 0 0 0 0 44 48 9 9 9 9 9 9 32 9 50 46 0 0 52 42 9 32 12 0 0 0 0 15 19 9 9 9 9 9 12 0 0 0
0 0 0 11 40 50 10 46 0 0 44 10 10 10 48 21 13 13 13 13 13 13 13 19 9 50 10 46 44 48 9 21 17 0 0 0 0 0 15 19 9 9 9 9 12 0 0 0
0 0 0 15 19 9 31 50 10 10 48 9 21 13 13 17 0 0 0 0 0 0 0 15 13 19 9 50 48 9 21 17 0 0 0 0 0 0 0 15 13 19 9 21 17 0 0 0
0 0 0 0 15 13 19 9 35 9 9 21 17 0 0 0 0 0 0 0 0 0 0 0 0 15 13 19 31 21 17 0 0 0 14 16 0 0 0 0 0 15 13 17 0 0 0 0
0 0 0 0 0 0 15 13 13 13 13 17 0 0 0 0 0 0 0 0 0 0 0 0 0 0 0 15 13 17 0 0 0 27 26 25 23 0 0 0 0 0 0 0 0 0 0 0
0 0 0 0 0 0 0 0 0 0 0 0 0 0 0 0 0 0 0 0 0 0 0 0 0 0 0 0 0 0 0 0 0 0 28 0 0 24 0 0 0 0 0 0 0 0 0 0
0 0 0 0 0 0 0 0 0 0 0 0 0 0 0 0 0 0 0 0 0 0 0 0 0 0 0 0 0 0 0 0 0 0 0 0 0 0 0 0 0 0 0 0 0 0 0 0