0 0 0 0 0 0 0 0 0 0 0 0 0 0 0 0 0 0 0 0 0 0 0 0 0 0 0 0 0 0 0 0 0 0 0 0 0 0 0 0 0 0 0 0 0 0 0 0
0 0 0 0 0 0 0 0 0 0 0 0 0 0 0 0 0 0 0 0 0 0 0 0 0 0 0 0 0 0 0 0 0 0 0 0 0 0 0 0 0 0 0 0 0 0 0 0
0 0 0 0 0 0 0 0 0 0 0 0 0 0 0 0 0 0 0 0 0 0 0 0 0 0 0 0 0 0 0 0 0 0 0 0 0 0 0 0 0 0 0 0 0 0 0 0
0 0 0 0 0 0 0 0 0 0 0 0 0 0 0 0 0 0 0 0 0 0 0 0 0 0 0 0 0 0 0 0 0 0 0 0 0 0 0 0 0 0 0 0 0 0 0 0
0 0 0 0 0 0 0 0 0 0 0 0 0 0 0 0 0 0 0 0 0 0 0 0 0 0 0 0 0 0 0 0 0 0 0 0 0 0 0 0 63 65 0 0 0 0 0 0
0 0 0 0 0 0 0 0 0 0 0 0 0 0 0 0 0 0 0 0 0 0 0 0 0 0 63 65 0 0 0 0 0 0 0 0 0 0 0 63 86 66 0 0 0 0 0 0
0 0 0 0 0 0 0 0 63 59 59 71 72 0 0 0 0 0 0 0 0 0 0 0 0 0 60 62 0 0 0 0 0 0 0 0 0 0 0 60 62 0 0 0 0 0 0 0
0 0 0 0 0 0 63 59 67 70 61 66 0 0 0 0 0 0 0 0 0 0 0 0 0 0 64 66 0 0 0 0 0 0 0 0 0 0 0 64 66 0 87 72 0 0 0 0
0 0 0 0 0 0 64 68 70 66 0 0 0 63 65 0 73 74 65 0 0 0 0 0 0 0 0 0 0 0 0 0 0 0 0 0 0 0 0 0 0 0 80 0 0 0 0 0
0 0 0 0 0 0 0 64 66 0 0 0 0 64 66 0 0 64 75 65 0 0 0 0 0 0 0 0 63 59 65 0 0 81 0 0 0 0 0 0 0 0 0 0 0 0 0 0
0 0 0 0 0 0 0 0 0 0 0 0 0 0 0 0 0 0 64 75 65 0 0 0 0 0 0 0 60 58 69 59 59 65 0 0 0 0 0 0 0 0 0 0 0 0 0 0
0 0 0 0 0 0 0 0 0 63 65 0 0 0 0 0 0 0 0 64 66 0 0 0 0 0 0 0 64 68 58 58 94 62 0 0 0 63 65 0 81 0 0 0 0 0 0 0
0 0 0 0 0 0 0 0 0 64 76 0 0 0 0 0 0 0 0 0 0 0 0 0 0 0 0 0 0 60 58 58 58 69 65 0 0 64 66 0 0 0 0 0 0 0 0 0
0 0 0 0 0 0 0 0 0 0 77 78 0 0 0 0 0 0 0 0 0 0 0 0 0 0 0 0 0 64 68 58 58 95 62 0 0 0 63 65 0 0 0 0 0 0 0 0
0 0 0 0 0 0 0 0 0 0 0 79 65 0 0 0 0 0 0 0 0 0 0 0 0 0 0 0 0 0 64 61 68 70 66 0 0 0 60 69 65 0 82 0 0 0 0 0
0 0 0 0 0 0 0 0 0 0 0 64 76 0 0 0 0 0 0 0 0 0 0 0 0 0 0 0 0 0 0 0 64 66 0 0 0 0 60 58 69 59 88 72 0 0 0 0
0 0 0 0 0 0 0 0 0 0 0 0 80 0 0 0 0 0 0 0 0 0 0 0 0 0 0 0 0 0 0 0 0 0 0 0 0 0 64 68 92 70 66 0 0 0 0 0
0 0 0 0 0 0 0 0 0 0 0 0 0 0 0 0 0 0 0 0 0 0 63 65 0 0 0 0 0 0 0 0 0 0 0 0 0 0 0 64 68 62 0 0 0 0 0 0
0 0 0 0 0 0 0 0 0 0 0 0 0 0 0 0 0 0 0 0 0 63 67 62 0 0 0 0 0 0 0 0 0 0 0 0 0 0 0 0 64 66 0 0 0 0 0 0
0 0 0 0 0 0 0 0 0 0 0 0 0 0 0 0 0 0 0 0 0 60 93 69 65 0 0 0 0 0 0 0 0 0 0 0 0 0 0 0 0 0 0 0 0 0 0 0
0 0 0 0 0 0 0 0 0 0 0 0 0 0 0 0 0 0 0 0 0 64 61 68 69 59 65 0 0 0 0 0 0 0 0 0 0 0 0 0 0 0 0 0 0 0 0 0
0 0 0 0 0 0 0 0 0 0 0 0 0 0 0 0 0 0 0 0 0 0 81 64 61 61 66 0 0 0 0 0 0 0 0 0 0 0 0 0 0 0 0 0 0 0 0 0
0 0 0 0 0 0 0 0 0 0 0 0 0 0 0 0 0 0 0 0 0 0 0 0 0 0 0 0 0 0 0 0 0 0 0 0 0 0 0 0 0 0 0 0 0 0 0 0
0 0 0 0 0 0 0 0 0 0 0 0 0 0 0 0 0 0 0 0 0 0 0 0 0 0 0 0 0 0 0 0 0 0 0 0 0 0 0 0 0 0 0 0 0 0 0 0
0 0 0 0 0 0 0 0 0 0 0 0 0 0 0 0 0 0 0 0 0 0 0 0 0 0 0 0 0 0 0 0 0 0 0 0 0 0 0 0 0 0 0 0 0 0 0 0
0 0 0 0 0 0 0 0 0 0 0 0 0 0 63 65 0 0 0 0 0 0 0 0 0 0 0 0 0 0 0 0 0 0 0 0 0 0 0 0 0 0 0 0 0 0 0 0
0 0 0 0 0 0 0 0 0 0 0 0 82 0 64 75 59 65 0 0 0 0 0 0 0 0 0 0 0 0 82 0 0 0 0 0 0 0 0 0 0 0 0 0 0 0 0 0
0 0 0 0 0 0 0 0 0 0 0 0 80 0 0 60 92 69 65 0 0 0 0 0 0 0 0 0 0 73 85 65 0 0 0 0 0 0 0 0 0 0 0 82 0 0 0 0
0 0 0 0 0 0 0 0 0 0 0 0 0 0 0 64 61 68 62 0 0 0 0 0 0 0 0 0 0 0 64 66 0 0 0 0 0 0 0 0 0 0 0 91 0 0 0 0
0 0 0 0 0 0 0 0 0 63 65 0 0 0 0 0 0 64 66 0 0 0 0 0 0 0 0 0 0 0 0 0 0 0 0 0 0 0 0 0 0 0 63 90 0 0 0 0
0 0 0 0 0 0 0 0 0 64 83 84 72 81 0 0 0 0 0 0 0 0 0 0 0 0 0 0 0 0 0 0 0 0 0 0 0 0 0 0 0 73 89 66 0 0 0 0
0 0 0 0 0 0 0 0 0 0 80 0 0 0 0 0 0 0 0 0 0 0 0 0 0 0 0 0 0 0 0 0 0 0 0 0 0 0 0 0 0 0 80 0 0 0 0 0
0 0 0 0 0 0 0 0 0 0 0 0 0 0 0 0 0 0 0 0 0 0 0 0 0 0 0 0 0 0 0 0 0 0 0 0 0 0 0 0 0 0 0 0 0 0 0 0
0 0 0 0 0 0 0 0 0 0 0 0 0 0 0 0 0 0 0 0 0 0 0 0 0 0 0 0 0 0 0 0 0 0 0 0 0 0 0 0 0 0 0 0 0 0 0 0
0 0 0 0 0 0 0 0 0 0 0 0 0 0 0 0 0 0 0 0 0 0 0 0 0 0 0 0 0 0 0 0 0 0 0 0 0 0 0 0 0 0 0 0 0 0 0 0
0 0 0 0 0 0 0 0 0 0 0 0 0 0 0 0 0 0 0 0 0 0 0 0 0 0 0 0 0 0 0 0 0 0 0 0 0 0 0 0 0 0 0 0 0 0 0 0